Dance Troupe	Dance_Troupe
Maha Bandula	Maha_Bandula
drawings are	drawings_are
Orphan Asylum	Orphan_Asylum
named “	named_“
moderate success	moderate_success
featured artist	featured_artist
In 1848	In_1848
residential districts	residential_districts
Rupert Penry-Jones	Rupert_Penry-Jones
but they divorced	but_they_divorced
Al Shabaab	Al_Shabaab
cubic lattice	cubic_lattice
Hal Blaine	Hal_Blaine
A champion seed	A_champion_seed
Suddenly Last	Suddenly_Last
Kwai Fong	Kwai_Fong
public defenders	public_defenders
TP Mazembe	TP_Mazembe
Milorad Dodik	Milorad_Dodik
Henry John	Henry_John
Harry Saltzman	Harry_Saltzman
Fall 2014	Fall_2014
record and perform	record_and_perform
steam engines	steam_engines
rushing for	rushing_for
Bayburt Bayburt	Bayburt_Bayburt
car accident	car_accident
promised them	promised_them
many fields	many_fields
Tech Prep	Tech_Prep
Sub-Aqua Club	Sub-Aqua_Club
The incident	The_incident
Sucker Punch	Sucker_Punch
Act amended	Act_amended
Verein zur	Verein_zur
professor emeritus	professor_emeritus
Stacia Proefrock	Stacia_Proefrock
son Arthur	son_Arthur
file contains	file_contains
$225 000	$225_000
Thales Alenia	Thales_Alenia
in Kosovo	in_Kosovo
subjecting them	subjecting_them
tin mines	tin_mines
side-by-side rowing	side-by-side_rowing
Doug Wright	Doug_Wright
widows and widowers	widows_and_widowers
troubled times	troubled_times
Employers Confederation	Employers_Confederation
Suresh Wadkar	Suresh_Wadkar
Salinas Valley	Salinas_Valley
Atlantic seaboard	Atlantic_seaboard
car salesman	car_salesman
indentured servants	indentured_servants
seven-game series	seven-game_series
warms up	warms_up
Judy Greer	Judy_Greer
Nachke Dikha	Nachke_Dikha
ε 0	ε_0
Lisson Gallery	Lisson_Gallery
Grupo Televisa	Grupo_Televisa
de Mendoza	de_Mendoza
the temple	the_temple
Queen Rania	Queen_Rania
Australasian Championships	Australasian_Championships
the Qin Dynasty	the_Qin_Dynasty
political upheavals	political_upheavals
40-man roster	40-man_roster
Unfunded Mandates	Unfunded_Mandates
his main interest	his_main_interest
Islamic sciences	Islamic_sciences
Duke Ellington	Duke_Ellington
miscarriage of justice	miscarriage_of_justice
Biblioteca Marciana	Biblioteca_Marciana
Kjell Magne Bondevik	Kjell_Magne_Bondevik
AFL Draft	AFL_Draft
sent representatives to	sent_representatives_to
Van Nistelrooy	Van_Nistelrooy
was leaked	was_leaked
the 27th	the_27th
and runs into	and_runs_into
Propionibacterium acnes	Propionibacterium_acnes
Helikopter Service	Helikopter_Service
a blockade	a_blockade
Download Festival	Download_Festival
cure for	cure_for
attract tourists	attract_tourists
shade tree	shade_tree
consists largely of	consists_largely_of
Def Leppard	Def_Leppard
simulation video game	simulation_video_game
Lokomotiv Plovdiv	Lokomotiv_Plovdiv
Kent Hrbek	Kent_Hrbek
She transited	She_transited
Poison the Well	Poison_the_Well
requests from	requests_from
Seattle Metropolitans	Seattle_Metropolitans
Shortly thereafter	Shortly_thereafter
Miami-Fort Lauderdale	Miami-Fort_Lauderdale
Make You Mine	Make_You_Mine
mountain rescue	mountain_rescue
$9 billion	$9_billion
Topics covered include	Topics_covered_include
Cindy Sheehan	Cindy_Sheehan
descending from	descending_from
was re-created	was_re-created
do Amaral	do_Amaral
Franz Nopcsa	Franz_Nopcsa
Music Inc	Music_Inc
El Texano	El_Texano
Missouri Senate	Missouri_Senate
constitutional right	constitutional_right
in 1817	in_1817
collided with	collided_with
Persian خرم	Persian_خرم
Richard Seddon	Richard_Seddon
her last	her_last
Tessa Jowell	Tessa_Jowell
his request	his_request
a novelist	a_novelist
coastal cliffs	coastal_cliffs
Good Practice	Good_Practice
adoptive mother	adoptive_mother
classified under	classified_under
In Praise of	In_Praise_of
Kopparbergs Göteborg	Kopparbergs_Göteborg
Miikka Kiprusoff	Miikka_Kiprusoff
Delle Donne	Delle_Donne
Sheikh Mohammed	Sheikh_Mohammed
Allied governments	Allied_governments
Bade Ghulam	Bade_Ghulam
René Auberjonois	René_Auberjonois
equivalent to	equivalent_to
Linux OS	Linux_OS
heroes and villains	heroes_and_villains
elementary school	elementary_school
Contracting Parties	Contracting_Parties
at Pride Park	at_Pride_Park
IND Concourse	IND_Concourse
meditation on	meditation_on
their concerts	their_concerts
Urban Districts	Urban_Districts
in shaping	in_shaping
Gmina Goleniów within	Gmina_Goleniów_within
a confession	a_confession
reed organ	reed_organ
Institute for	Institute_for
shopping malls	shopping_malls
political crises	political_crises
Annual Conferences	Annual_Conferences
PET bottles	PET_bottles
Philip Rivers	Philip_Rivers
Baptist church	Baptist_church
told by	told_by
hopes to	hopes_to
destined to	destined_to
South African international	South_African_international
Kevin Sumlin	Kevin_Sumlin
Harold Laski	Harold_Laski
tells about	tells_about
Joan Fontaine	Joan_Fontaine
provided through	provided_through
Sakha Republic	Sakha_Republic
Bedtime Stories	Bedtime_Stories
Act II	Act_II
Le Jeune	Le_Jeune
casting doubt	casting_doubt
high frequencies	high_frequencies
aided and abetted	aided_and_abetted
Northern Ostrobothnia	Northern_Ostrobothnia
forced marriages	forced_marriages
wants to	wants_to
at Bellator	at_Bellator
sports anchor	sports_anchor
The 2013 season	The_2013_season
Super Bowls	Super_Bowls
Neotropical ecozone	Neotropical_ecozone
Hsieh Su-wei	Hsieh_Su-wei
was really	was_really
religious ceremonies	religious_ceremonies
Operational squadrons	Operational_squadrons
Ashford Simpson	Ashford_Simpson
Tazeh Kand-e	Tazeh_Kand-e
National Flag	National_Flag
anti-money laundering	anti-money_laundering
Roker Park	Roker_Park
Tony Gonzalez	Tony_Gonzalez
landfalls extratropical transitions	landfalls_extratropical_transitions
Manchester Cathedral	Manchester_Cathedral
Karst topography	Karst_topography
an uneventful	an_uneventful
clothing designer	clothing_designer
Bob Clampett	Bob_Clampett
Lori McNeil	Lori_McNeil
rural school districts	rural_school_districts
Shanghai Beijing	Shanghai_Beijing
Proto-Indo-European PIE	Proto-Indo-European_PIE
Kūkō IATA	Kūkō_IATA
in order that	in_order_that
lower elevation	lower_elevation
his fellows	his_fellows
Gurbanguly Berdimuhamedov	Gurbanguly_Berdimuhamedov
an entire	an_entire
electrical outlet	electrical_outlet
an Associate	an_Associate
Growling Tigers	Growling_Tigers
artillery batteries	artillery_batteries
Fort Gordon	Fort_Gordon
Serban Ghenea	Serban_Ghenea
the field he	the_field_he
Gary Russell	Gary_Russell
Interview magazine	Interview_magazine
Our Last	Our_Last
has been capped	has_been_capped
Jezreel Valley	Jezreel_Valley
and enlarged	and_enlarged
human emotions	human_emotions
the Regent s	the_Regent_s
Joint Distribution	Joint_Distribution
compete together	compete_together
panned by critics	panned_by_critics
Several scholars	Several_scholars
Red Line	Red_Line
Deportivo Español	Deportivo_Español
million items	million_items
mentally incompetent	mentally_incompetent
funded by	funded_by
executive bureau	executive_bureau
has rarely been	has_rarely_been
El Roumi	El_Roumi
delimited by	delimited_by
Ichikawa Danjūrō	Ichikawa_Danjūrō
Neuberger Berman	Neuberger_Berman
irreparably damaged	irreparably_damaged
product liability	product_liability
all life on	all_life_on
Dehaj District	Dehaj_District
ensued with	ensued_with
Amr Diab	Amr_Diab
Technical Staff	Technical_Staff
during the brief	during_the_brief
Houbraken he	Houbraken_he
National Stud	National_Stud
Political Cesspool	Political_Cesspool
Sealab 2021	Sealab_2021
Visiting Fellow	Visiting_Fellow
high energy	high_energy
Cyril Washbrook	Cyril_Washbrook
Utagawa Kunisada	Utagawa_Kunisada
Interbank Offered	Interbank_Offered
her grave	her_grave
in 1831	in_1831
Boswell s	Boswell_s
handheld devices	handheld_devices
in the leg	in_the_leg
Biblical Seminary	Biblical_Seminary
ALGOL 68	ALGOL_68
do not	do_not
Sông Lam Nghệ	Sông_Lam_Nghệ
Atlanta July 22-August	Atlanta_July_22-August
س ُ	س_ُ
10 a m	10_a_m
Jermaine Dupri	Jermaine_Dupri
British protectorate	British_protectorate
59 8	59_8
FC Groningen	FC_Groningen
much effort	much_effort
BBC 6	BBC_6
every 4 years	every_4_years
slumber party	slumber_party
presumed lost	presumed_lost
Nguyen Ngoc	Nguyen_Ngoc
would employ	would_employ
Campeonato Brasileiro	Campeonato_Brasileiro
OverClocked ReMix	OverClocked_ReMix
coping skills	coping_skills
Lubbock Texas	Lubbock_Texas
Blind Guardian	Blind_Guardian
withdrawn from	withdrawn_from
divided four-lane	divided_four-lane
resting place	resting_place
million in sales	million_in_sales
Thankful Villages	Thankful_Villages
Neon Trees	Neon_Trees
Arrive Alive	Arrive_Alive
resolves to	resolves_to
Pran Nath	Pran_Nath
copper oxide	copper_oxide
testify that	testify_that
the Baskervilles	the_Baskervilles
Averell Harriman	Averell_Harriman
metal frame	metal_frame
Országos Bajnokság	Országos_Bajnokság
Monday November	Monday_November
the Ohio Senate	the_Ohio_Senate
Curling Association	Curling_Association
is not visible	is_not_visible
Mister Terrific	Mister_Terrific
evacuation of	evacuation_of
Nagorno-Karabakh Republic	Nagorno-Karabakh_Republic
the oceans	the_oceans
strengthened into	strengthened_into
riders from	riders_from
Javier Saviola	Javier_Saviola
Indianapolis Raceway Park	Indianapolis_Raceway_Park
Field Hospital	Field_Hospital
was $34	was_$34
lit year name	lit_year_name
da Vida	da_Vida
aged 14	aged_14
likeness of	likeness_of
relative frequency	relative_frequency
aerial warfare	aerial_warfare
ISO 3166	ISO_3166
their destination	their_destination
a thirty-year	a_thirty-year
is famous as	is_famous_as
Milwaukee Braves	Milwaukee_Braves
Jean-Baptiste Mondino	Jean-Baptiste_Mondino
– 1979	–_1979
first published on	first_published_on
Sola Scriptura	Sola_Scriptura
Treat Me	Treat_Me
40-yard dash	40-yard_dash
Société Anonyme	Société_Anonyme
Fantasy Science Fiction	Fantasy_Science_Fiction
Fencing Federation	Fencing_Federation
piano organ	piano_organ
expressed their concern	expressed_their_concern
was played against	was_played_against
market index	market_index
White Cliffs	White_Cliffs
Upland School District	Upland_School_District
State Senator	State_Senator
Benigno Aquino	Benigno_Aquino
110 meter hurdles	110_meter_hurdles
genetic loci	genetic_loci
Stanley William Hayter	Stanley_William_Hayter
farther than	farther_than
the team from	the_team_from
AFL Premiership	AFL_Premiership
girl friend	girl_friend
Skate Park	Skate_Park
devoted most of	devoted_most_of
is a 1971	is_a_1971
Abd al-Qādir	Abd_al-Qādir
miraculous healing	miraculous_healing
Rhineland-Palatinate Germany	Rhineland-Palatinate_Germany
opéras comiques	opéras_comiques
Gonçalves Zarco	Gonçalves_Zarco
neutron stars	neutron_stars
at sunrise	at_sunrise
bonded to	bonded_to
in 1507	in_1507
is gone	is_gone
tectonic activity	tectonic_activity
the harbour	the_harbour
highly automated	highly_automated
a briefing	a_briefing
् वत	्_वत
basketball game	basketball_game
Fourier transform	Fourier_transform
statistical compilation by	statistical_compilation_by
thousand rupees	thousand_rupees
Progressive Party	Progressive_Party
living conditions	living_conditions
tort liability	tort_liability
in the south-west	in_the_south-west
younger siblings	younger_siblings
British consul	British_consul
Southern Conference	Southern_Conference
surrounding waters	surrounding_waters
The insignia	The_insignia
a Democrat	a_Democrat
The US Army	The_US_Army
Jack McDuff	Jack_McDuff
Orange Revolution	Orange_Revolution
is murdered by	is_murdered_by
metal halides	metal_halides
State Guard	State_Guard
Highly Qualified	Highly_Qualified
health resort	health_resort
Identity Cards	Identity_Cards
consider to be	consider_to_be
wikitable succession-box	wikitable_succession-box
Keeper of	Keeper_of
unstressed syllables	unstressed_syllables
Articles of Confederation	Articles_of_Confederation
in a season	in_a_season
way of doing	way_of_doing
endeared himself to	endeared_himself_to
West Kirby	West_Kirby
Redondo Beach	Redondo_Beach
turned over	turned_over
torrential downpour	torrential_downpour
Rillington Place	Rillington_Place
Zaporizhian Host	Zaporizhian_Host
Between 1994	Between_1994
provoked by	provoked_by
Hitman Reborn	Hitman_Reborn
his arm	his_arm
escaped capture	escaped_capture
Shari ah	Shari_ah
rectus femoris	rectus_femoris
assurance that	assurance_that
Blur s	Blur_s
before heading	before_heading
Russian SFSR	Russian_SFSR
M40 motorway	M40_motorway
By 1956	By_1956
Soviet intelligence	Soviet_intelligence
Butterfield Overland	Butterfield_Overland
Weather Forecast	Weather_Forecast
Best Books	Best_Books
Film critic	Film_critic
at sea with	at_sea_with
Tension between	Tension_between
Communications Network	Communications_Network
compatible computers	compatible_computers
tou dromou	tou_dromou
Fight Like Apes	Fight_Like_Apes
military service	military_service
gave recitals	gave_recitals
hunting ground	hunting_ground
Jens Lekman	Jens_Lekman
Zyuden Sentai Kyoryuger	Zyuden_Sentai_Kyoryuger
dialect continuum	dialect_continuum
Hedo Türkoğlu	Hedo_Türkoğlu
claims against	claims_against
Sheung Shui	Sheung_Shui
Metropolitan Stadium	Metropolitan_Stadium
José Maria	José_Maria
– 1936	–_1936
Warriston Cemetery	Warriston_Cemetery
Deanna Troi	Deanna_Troi
Davie Florida	Davie_Florida
Super Soaker	Super_Soaker
at up to	at_up_to
Republican nominee	Republican_nominee
melting glaciers	melting_glaciers
Monte Bello	Monte_Bello
Oakland A s	Oakland_A_s
pituitary adenoma	pituitary_adenoma
smaller firms	smaller_firms
Seattle Storm	Seattle_Storm
Orange California	Orange_California
In 1567	In_1567
unwed mother	unwed_mother
Richard T	Richard_T
customs officers	customs_officers
prefrontal cortex	prefrontal_cortex
Comedy Club	Comedy_Club
document containing	document_containing
heated up	heated_up
Huntsville AL	Huntsville_AL
Sinéad Cusack	Sinéad_Cusack
transitional justice	transitional_justice
Born Sinner	Born_Sinner
the Valiants	the_Valiants
would survive	would_survive
Diane Cilento	Diane_Cilento
Cape Farewell	Cape_Farewell
athletics events	athletics_events
Rookwood Cemetery	Rookwood_Cemetery
lieutenant governors	lieutenant_governors
Katalog Film Indonesia	Katalog_Film_Indonesia
the shaping of	the_shaping_of
at 28 August	at_28_August
Jimmie Foxx	Jimmie_Foxx
explanatory variable	explanatory_variable
a motion of	a_motion_of
is grown	is_grown
wireless network	wireless_network
an article from	an_article_from
and video recordings	and_video_recordings
rampant corruption	rampant_corruption
countless other	countless_other
24 2	24_2
IgA nephropathy	IgA_nephropathy
Northern Beaches	Northern_Beaches
Kansas Legislature	Kansas_Legislature
political appointments	political_appointments
Zhongshu Shilang 中書侍郎	Zhongshu_Shilang_中書侍郎
Stu Hart	Stu_Hart
the team for	the_team_for
McAllen Texas	McAllen_Texas
Olimpia Milano	Olimpia_Milano
tempered glass	tempered_glass
general manager	general_manager
Jim Stynes	Jim_Stynes
Elm Yellows	Elm_Yellows
at Mosport	at_Mosport
unseeded teams	unseeded_teams
the 18th season	the_18th_season
alluding to	alluding_to
family Rutaceae	family_Rutaceae
role-playing games	role-playing_games
Old Colony	Old_Colony
premeditated murder	premeditated_murder
Mister Mind	Mister_Mind
Each participant	Each_participant
Tracie Thoms	Tracie_Thoms
Ramya Krishna	Ramya_Krishna
USL PDL	USL_PDL
motivating force	motivating_force
Shaka Hislop	Shaka_Hislop
Brock s	Brock_s
fertile valley	fertile_valley
Slate Meagher Flom	Slate_Meagher_Flom
a shelter for	a_shelter_for
was remastered	was_remastered
geodesic equation	geodesic_equation
Radioland Murders	Radioland_Murders
Must Pass	Must_Pass
500 m	500_m
59 minutes	59_minutes
ubiquitin-protein ligase	ubiquitin-protein_ligase
rose above	rose_above
Born on	Born_on
the end she	the_end_she
Roxbury Massachusetts	Roxbury_Massachusetts
Faulkes Telescope	Faulkes_Telescope
police procedural	police_procedural
style dwelling	style_dwelling
an amplifier	an_amplifier
male counterpart	male_counterpart
Ordnance Factories	Ordnance_Factories
Nate Marquardt	Nate_Marquardt
Pablo Milanés	Pablo_Milanés
After one season	After_one_season
the ordination of	the_ordination_of
The Jeffersons	The_Jeffersons
Ang Panday	Ang_Panday
advantageous for	advantageous_for
Jessica Chastain	Jessica_Chastain
The Role of	The_Role_of
refugee camps	refugee_camps
his uncles	his_uncles
overseas tour	overseas_tour
telephone directories	telephone_directories
and Palestine Campaign	and_Palestine_Campaign
an oven	an_oven
idiopathic hypersomnia	idiopathic_hypersomnia
The Only Way	The_Only_Way
less success	less_success
sort that column	sort_that_column
the organisers	the_organisers
their sentences	their_sentences
Rika Ishikawa	Rika_Ishikawa
David C	David_C
Mbit s	Mbit_s
the immediate vicinity	the_immediate_vicinity
in 1460	in_1460
in the months	in_the_months
Memory Lane	Memory_Lane
volcanic tuff	volcanic_tuff
A R Labs	A_R_Labs
Holdings Berhad	Holdings_Berhad
enzymatic reactions	enzymatic_reactions
Crişul Alb	Crişul_Alb
spin-off series	spin-off_series
Gregorian Calendar	Gregorian_Calendar
underwent another	underwent_another
ബഹ ു.	ബഹ_ു.
could hear	could_hear
charitable endeavors	charitable_endeavors
Maraimalai Adigal	Maraimalai_Adigal
travel guides	travel_guides
Beitar Jerusalem	Beitar_Jerusalem
Green Goblin	Green_Goblin
cars and motorcycles	cars_and_motorcycles
hostages were	hostages_were
qualifying games	qualifying_games
Kanyakumari district	Kanyakumari_district
segmented into	segmented_into
high-income countries	high-income_countries
No 82	No_82
€ 1	€_1
detection range	detection_range
an incompetent	an_incompetent
contract expiring	contract_expiring
Cajanus cajan	Cajanus_cajan
felled by	felled_by
in place to	in_place_to
in Dnipropetrovsk	in_Dnipropetrovsk
the intent of	the_intent_of
Aras River	Aras_River
Recording Arts	Recording_Arts
Persona 4	Persona_4
balance sheet	balance_sheet
in 2006 it	in_2006_it
expand rapidly	expand_rapidly
this thing	this_thing
She accepts	She_accepts
Wang Jing	Wang_Jing
neighboring municipality	neighboring_municipality
pilgrimage route	pilgrimage_route
Municipality Norrbotten	Municipality_Norrbotten
Nguyen Thi	Nguyen_Thi
an award-winning	an_award-winning
km relay	km_relay
financial meltdown	financial_meltdown
and Staff Course	and_Staff_Course
On 17	On_17
cable system	cable_system
La Cité	La_Cité
Metropolitan School District	Metropolitan_School_District
Mac computers	Mac_computers
Lionel Barrymore	Lionel_Barrymore
From 1983	From_1983
de Sanctis	de_Sanctis
domed roof	domed_roof
a welfare state	a_welfare_state
application developers	application_developers
smeared with	smeared_with
Charlie Crist	Charlie_Crist
To establish	To_establish
20 to 40	20_to_40
jet fighters	jet_fighters
manual labour	manual_labour
subject to	subject_to
consulting firm	consulting_firm
Mirogoj Cemetery	Mirogoj_Cemetery
Eulogy Recordings	Eulogy_Recordings
was activated	was_activated
Valentina Tereshkova	Valentina_Tereshkova
These devices	These_devices
the common name	the_common_name
PlayStation Home	PlayStation_Home
the upper	the_upper
Information System	Information_System
200-metre freestyle	200-metre_freestyle
Golden Valley	Golden_Valley
draws against	draws_against
$4.4 billion	$4.4_billion
Maharaja Sayajirao	Maharaja_Sayajirao
singles released	singles_released
Kanab Utah	Kanab_Utah
fade into	fade_into
the frontman of	the_frontman_of
Preacher Man	Preacher_Man
cervical vertebra	cervical_vertebra
cardboard boxes	cardboard_boxes
Božena Němcová	Božena_Němcová
cyclic group	cyclic_group
Ngāti Ruanui	Ngāti_Ruanui
Cyborg 009	Cyborg_009
Trumbull Connecticut	Trumbull_Connecticut
Insensato Coração	Insensato_Coração
surrogate mother	surrogate_mother
Gjergj Arianiti	Gjergj_Arianiti
Abdul Qader	Abdul_Qader
laws that	laws_that
real ales	real_ales
Fighting Talk	Fighting_Talk
Miloš Obrenović	Miloš_Obrenović
Yarlung Tsangpo	Yarlung_Tsangpo
high technology	high_technology
this country	this_country
Luft- und Raumfahrt	Luft-_und_Raumfahrt
TV and film	TV_and_film
fractured cheekbone	fractured_cheekbone
portrait of	portrait_of
either alone	either_alone
Kellogg Company	Kellogg_Company
16th Karmapa	16th_Karmapa
my job	my_job
without discrimination	without_discrimination
de Borja	de_Borja
public speech	public_speech
rapid intensification	rapid_intensification
kept alive	kept_alive
TV programme	TV_programme
Lukáš Dlouhý	Lukáš_Dlouhý
the backup quarterback	the_backup_quarterback
the third-best	the_third-best
Chess Congress	Chess_Congress
Adirondack Northway	Adirondack_Northway
Trier-Saarburg district	Trier-Saarburg_district
survey vessel	survey_vessel
Journals Online	Journals_Online
need special education	need_special_education
Vijay Anand	Vijay_Anand
may not	may_not
Jin s	Jin_s
SportsChannel America	SportsChannel_America
Jim Steranko	Jim_Steranko
Twenty-seventh Congress	Twenty-seventh_Congress
maxillary barbels	maxillary_barbels
Banco Mercantil	Banco_Mercantil
Elysian Park	Elysian_Park
the clitoris	the_clitoris
distribution network	distribution_network
prayed for	prayed_for
This also allows	This_also_allows
a prince	a_prince
Appreciation Society	Appreciation_Society
the fixed point	the_fixed_point
Jagathi Sreekumar	Jagathi_Sreekumar
two battleships	two_battleships
Fiscal Responsibility	Fiscal_Responsibility
Other languages	Other_languages
in Laos	in_Laos
provoked outrage	provoked_outrage
30 7	30_7
modeled using	modeled_using
a nameless	a_nameless
Airbus A320s	Airbus_A320s
in Division 3	in_Division_3
Metallurgical Engineering	Metallurgical_Engineering
national sport	national_sport
5th season	5th_season
Alberto Sordi	Alberto_Sordi
RNA-binding protein	RNA-binding_protein
sodium hydroxide	sodium_hydroxide
Antarctic krill	Antarctic_krill
Rahat Fateh	Rahat_Fateh
culmination of	culmination_of
no Michi	no_Michi
pursuant to	pursuant_to
help me	help_me
can sometimes	can_sometimes
written in German	written_in_German
the ECHL	the_ECHL
Judas Priest	Judas_Priest
Research Fellowship	Research_Fellowship
family Clausiliidae	family_Clausiliidae
would still be	would_still_be
grade ranked	grade_ranked
Primary Education	Primary_Education
sonnō jōi	sonnō_jōi
some 6 000	some_6_000
slotted flaps	slotted_flaps
Another name for	Another_name_for
considered taboo	considered_taboo
less stringent	less_stringent
security officer	security_officer
has not played	has_not_played
Community Association	Community_Association
tuberous sclerosis	tuberous_sclerosis
180 kg	180_kg
Bircham Newton	Bircham_Newton
Molecule Man	Molecule_Man
lush vegetation	lush_vegetation
6th Viscount	6th_Viscount
warns her that	warns_her_that
our senses	our_senses
Ó Ceallaigh	Ó_Ceallaigh
solar photovoltaics	solar_photovoltaics
finds herself	finds_herself
45 minute	45_minute
New Male Talent	New_Male_Talent
bats are	bats_are
paramilitary organisation	paramilitary_organisation
Alan Smithee	Alan_Smithee
Alan Shatter	Alan_Shatter
Philadelphia Mint	Philadelphia_Mint
kill herself	kill_herself
Eddie s	Eddie_s
They Came	They_Came
biblical scholar	biblical_scholar
owned it until	owned_it_until
Wesley Morris	Wesley_Morris
a three-year	a_three-year
Green Team	Green_Team
After examining	After_examining
Arseny Semionov	Arseny_Semionov
063 for females	063_for_females
possessive suffix	possessive_suffix
Wild Hunt	Wild_Hunt
sees through	sees_through
Tarxien Rainbows	Tarxien_Rainbows
prevented from	prevented_from
before election day	before_election_day
in 47 games	in_47_games
tax on	tax_on
Business Process	Business_Process
Banat of Temeschwar	Banat_of_Temeschwar
Ozone Layer Protection	Ozone_Layer_Protection
Torrie Wilson	Torrie_Wilson
De Aar	De_Aar
NASCAR Busch	NASCAR_Busch
Production designer	Production_designer
García born	García_born
Lana Parrilla	Lana_Parrilla
255 255	255_255
devoted himself to	devoted_himself_to
snippet of	snippet_of
murex snails	murex_snails
public transit	public_transit
takes place	takes_place
nearly circular	nearly_circular
Diamond Jaxx	Diamond_Jaxx
්‍ ර	්‍_ර
acting skills	acting_skills
the protagonist	the_protagonist
voiced concern	voiced_concern
closer inspection	closer_inspection
is not normally	is_not_normally
which 28 8	which_28_8
gastropod mollusc	gastropod_mollusc
Yeh Rishta	Yeh_Rishta
David Ben-Gurion	David_Ben-Gurion
ecclesiastical court	ecclesiastical_court
Dirty Laundry	Dirty_Laundry
Seven Cities	Seven_Cities
comedy pilot	comedy_pilot
send them	send_them
logging road	logging_road
Leon Schlesinger	Leon_Schlesinger
Whaling Company	Whaling_Company
Metropolitan Police	Metropolitan_Police
at Georgetown	at_Georgetown
Midi-Pyrénées France	Midi-Pyrénées_France
Kokuritsu Kōen	Kokuritsu_Kōen
Santosh Trophy	Santosh_Trophy
distressed by	distressed_by
Quatre Bornes	Quatre_Bornes
similar in appearance	similar_in_appearance
proton transfer	proton_transfer
all-round performance	all-round_performance
could provide	could_provide
Paizo Publishing s	Paizo_Publishing_s
DDR SDRAM	DDR_SDRAM
NHRA Mello Yello	NHRA_Mello_Yello
Alfred I duPont	Alfred_I_duPont
Lubycza Królewska	Lubycza_Królewska
athletic fields	athletic_fields
fateful decision	fateful_decision
gradually become	gradually_become
sniper rifles	sniper_rifles
NBA Live	NBA_Live
Nature Sanctuary	Nature_Sanctuary
musical artist	musical_artist
before retiring	before_retiring
relieve overcrowding	relieve_overcrowding
Arkadelphia Arkansas	Arkadelphia_Arkansas
vibrational energy	vibrational_energy
Tylwyth Teg	Tylwyth_Teg
Shaikh Hamad	Shaikh_Hamad
় দ	়_দ
Symbolic Logic	Symbolic_Logic
Buckminster Fuller	Buckminster_Fuller
all sources ranked	all_sources_ranked
Marine Force	Marine_Force
guest star	guest_star
pilgrimage to	pilgrimage_to
limiting or prohibiting	limiting_or_prohibiting
Jalal Talabani	Jalal_Talabani
Sheepshead Bay	Sheepshead_Bay
34th season	34th_season
broadcast tower	broadcast_tower
at the 2012	at_the_2012
DIY ethic	DIY_ethic
Extended Mix	Extended_Mix
buzzer beater	buzzer_beater
Dheeran Chinnamalai	Dheeran_Chinnamalai
neglected tropical diseases	neglected_tropical_diseases
their decisions	their_decisions
Société entomologique	Société_entomologique
Freddie Hubbard	Freddie_Hubbard
spangled grey plumage	spangled_grey_plumage
Tom Thumb	Tom_Thumb
during the 1972	during_the_1972
The Town of	The_Town_of
endangered animals	endangered_animals
Bonnie Hunt	Bonnie_Hunt
00 P M	00_P_M
8th centuries	8th_centuries
If these	If_these
Special Effects	Special_Effects
National Coalition	National_Coalition
The constitution	The_constitution
Awami League	Awami_League
water buffalo	water_buffalo
Esoteric Buddhism	Esoteric_Buddhism
This increases	This_increases
The Incredible	The_Incredible
BGO Records	BGO_Records
Aaronic priesthood	Aaronic_priesthood
information visualization	information_visualization
characters names	characters_names
the name change	the_name_change
– 91	–_91
cardiac tamponade	cardiac_tamponade
binomial name	binomial_name
European Americans	European_Americans
Gary Bettman	Gary_Bettman
fall winter	fall_winter
Aerolíneas Argentinas	Aerolíneas_Argentinas
per 0 01	per_0_01
Wissenschaft des Judentums	Wissenschaft_des_Judentums
paid-up capital	paid-up_capital
Marquee Club	Marquee_Club
non-residential buildings	non-residential_buildings
episode Recurring	episode_Recurring
ecclesiastical discipline	ecclesiastical_discipline
La Bouche	La_Bouche
Joan Gamper	Joan_Gamper
Tony Trabert	Tony_Trabert
Main Range	Main_Range
Eamonn Holmes	Eamonn_Holmes
Forschungsanstalt für	Forschungsanstalt_für
Cardiff Castle	Cardiff_Castle
Theodor Mommsen	Theodor_Mommsen
Chips Rafferty	Chips_Rafferty
Li Keqiang	Li_Keqiang
grunge movement	grunge_movement
Orthodox Church	Orthodox_Church
the caldera	the_caldera
putting down	putting_down
Frank Herbert s	Frank_Herbert_s
Primer Impacto	Primer_Impacto
Saratoga CV-3	Saratoga_CV-3
several CDs	several_CDs
Computer Society	Computer_Society
Fast Forward	Fast_Forward
Chris Eubank	Chris_Eubank
He also taught	He_also_taught
Diet of Worms	Diet_of_Worms
drawn against	drawn_against
an interesting	an_interesting
free online	free_online
and community organizations	and_community_organizations
psychiatric conditions	psychiatric_conditions
Montgomery C Meigs	Montgomery_C_Meigs
Broome Street	Broome_Street
Bachao Andolan	Bachao_Andolan
Anna Politkovskaya	Anna_Politkovskaya
She had been	She_had_been
three-body problem	three-body_problem
Morbid Angel	Morbid_Angel
Harbin Heilongjiang	Harbin_Heilongjiang
Keith Forsey	Keith_Forsey
” and “	”_and_“
Upper Peninsula	Upper_Peninsula
characters are	characters_are
Nawab Nazim	Nawab_Nazim
the efforts of	the_efforts_of
brought with it	brought_with_it
Thái Tông	Thái_Tông
domestic cats	domestic_cats
Sino-Tibetan language	Sino-Tibetan_language
symbols are	symbols_are
du Capitole	du_Capitole
Divinity School	Divinity_School
hovered around	hovered_around
া দ	া_দ
charitable institution	charitable_institution
Lotus corniculatus	Lotus_corniculatus
Halit Refiğ	Halit_Refiğ
license plates	license_plates
a service SaaS	a_service_SaaS
was positioned	was_positioned
the hurricane	the_hurricane
natural scenery	natural_scenery
six-song EP	six-song_EP
White Americans	White_Americans
flowers are	flowers_are
was self-released	was_self-released
Zoran Janković	Zoran_Janković
He enjoys	He_enjoys
Cradley Heath	Cradley_Heath
detected by	detected_by
De Oro	De_Oro
techniques are	techniques_are
Russian Илья	Russian_Илья
and elected to	and_elected_to
million records	million_records
Up and Down	Up_and_Down
Bhupen Hazarika	Bhupen_Hazarika
our economy	our_economy
Conseco Fieldhouse	Conseco_Fieldhouse
Transverse Ranges	Transverse_Ranges
extradited to	extradited_to
Cab Calloway	Cab_Calloway
phage display	phage_display
จ ั	จ_ั
Strategic Wing	Strategic_Wing
Idris Elba	Idris_Elba
intended victim	intended_victim
so rapidly	so_rapidly
governed by	governed_by
F91 Dudelange	F91_Dudelange
her masts	her_masts
Diamond Sutra	Diamond_Sutra
cycled through	cycled_through
GMA Telebabad	GMA_Telebabad
advisor to	advisor_to
would facilitate	would_facilitate
– 1837	–_1837
Jesse Pinkman	Jesse_Pinkman
prayer beads	prayer_beads
precipitated by	precipitated_by
protest marches	protest_marches
Marty McSorley	Marty_McSorley
Dieterich Buxtehude	Dieterich_Buxtehude
Mark Coleman	Mark_Coleman
Leipziger Platz	Leipziger_Platz
third-placed team	third-placed_team
Hindu Brahmin	Hindu_Brahmin
loved it	loved_it
Dorje Shugden	Dorje_Shugden
Sleeping Dogs	Sleeping_Dogs
uniformity of	uniformity_of
Humanae vitae	Humanae_vitae
Mick McCarthy	Mick_McCarthy
Aşk-ı Memnu	Aşk-ı_Memnu
episcopi vagantes	episcopi_vagantes
Quack Pack	Quack_Pack
Illegal immigration	Illegal_immigration
and index finger	and_index_finger
the tagline	the_tagline
Carbondale Area	Carbondale_Area
Bow Street	Bow_Street
take photos	take_photos
a light-hearted	a_light-hearted
Detective Story	Detective_Story
Lord Derby	Lord_Derby
cardboard cutouts	cardboard_cutouts
saved from	saved_from
an electorate	an_electorate
Bruce Spizer	Bruce_Spizer
walking tour	walking_tour
bout with	bout_with
corpora cavernosa	corpora_cavernosa
jazz clarinetist	jazz_clarinetist
Democratic primary with	Democratic_primary_with
Order Restoration Council	Order_Restoration_Council
umbilical cord	umbilical_cord
Naval Officer	Naval_Officer
Sin Salida	Sin_Salida
field crops	field_crops
Digital Economy	Digital_Economy
the TTC	the_TTC
limited-access freeway	limited-access_freeway
ashlar masonry	ashlar_masonry
occupied Europe	occupied_Europe
the air with	the_air_with
in the 1963	in_the_1963
a plantation	a_plantation
a Scottish former	a_Scottish_former
Andy s	Andy_s
competes against	competes_against
its extensive	its_extensive
Metropolis Records	Metropolis_Records
SO4 2	SO4_2
cover photograph	cover_photograph
latissimus dorsi	latissimus_dorsi
their daughters	their_daughters
Anantnag district	Anantnag_district
Tony Wilson	Tony_Wilson
Leaving Cert	Leaving_Cert
judicial commission	judicial_commission
Nassau Inter-County Express	Nassau_Inter-County_Express
passed on	passed_on
cut from	cut_from
Channeled Scablands	Channeled_Scablands
Malcolm Bradbury	Malcolm_Bradbury
respiratory muscles	respiratory_muscles
World Group	World_Group
Alexei Mikhailovich	Alexei_Mikhailovich
Water Management	Water_Management
bout via	bout_via
drumming duties	drumming_duties
support up to	support_up_to
no substantial	no_substantial
two extra	two_extra
Adventure Gamers	Adventure_Gamers
at hooker	at_hooker
Notitia Episcopatuum	Notitia_Episcopatuum
both genders	both_genders
The first song	The_first_song
evangelistic work	evangelistic_work
Little Shop	Little_Shop
learn to	learn_to
the highlands	the_highlands
predicated on	predicated_on
Ladybower Reservoir	Ladybower_Reservoir
Nick Lowe	Nick_Lowe
Qualification Tournament	Qualification_Tournament
households watching	households_watching
Itzhak Perlman	Itzhak_Perlman
Tous les	Tous_les
Dhaulagiri Zone	Dhaulagiri_Zone
The southernmost	The_southernmost
Monoclonal antibodies	Monoclonal_antibodies
Glitch Mob	Glitch_Mob
what was happening	what_was_happening
baal teshuva	baal_teshuva
Multiple studies	Multiple_studies
The Venetian	The_Venetian
tidal waves	tidal_waves
mastermind behind	mastermind_behind
fossil footprints	fossil_footprints
his murder	his_murder
La Niña	La_Niña
Mi irabawi	Mi_irabawi
take time off	take_time_off
Savonlinna Opera Festival	Savonlinna_Opera_Festival
Nicolas Soult	Nicolas_Soult
swath of	swath_of
Sarath Kumar	Sarath_Kumar
rising to	rising_to
rotary converters	rotary_converters
his innocence	his_innocence
St Anselm	St_Anselm
They subsequently	They_subsequently
xeroderma pigmentosum	xeroderma_pigmentosum
Pittsburgh Pipers	Pittsburgh_Pipers
synthetic rubber	synthetic_rubber
reacted negatively to	reacted_negatively_to
Teen Vogue	Teen_Vogue
Roast Beef	Roast_Beef
Morgan who	Morgan_who
Hebrew name	Hebrew_name
apologizing for	apologizing_for
Alma Ata	Alma_Ata
All-Big East	All-Big_East
R $297.00 respectively	R_$297.00_respectively
Current Affairs	Current_Affairs
the fields of	the_fields_of
Head coach	Head_coach
Fundamental Orders	Fundamental_Orders
daughter Dorothy	daughter_Dorothy
the two-year middle	the_two-year_middle
Galleria Borghese	Galleria_Borghese
how long	how_long
Fabrizio Miccoli	Fabrizio_Miccoli
Osteopathic Association	Osteopathic_Association
drops to	drops_to
Will Always	Will_Always
State University OSU	State_University_OSU
A Voyage	A_Voyage
Public Integrity	Public_Integrity
was a Croatian	was_a_Croatian
Direct Democracy	Direct_Democracy
Memorial Tollway	Memorial_Tollway
Kenny Burrell	Kenny_Burrell
two competitors	two_competitors
Wound Badge	Wound_Badge
a duel	a_duel
Dante Alighieri	Dante_Alighieri
World Summit	World_Summit
and bassist	and_bassist
Brees completed	Brees_completed
Red Crow	Red_Crow
tin miners	tin_miners
Rookery Nook	Rookery_Nook
signed for	signed_for
State Hermitage	State_Hermitage
the skies	the_skies
Cambyses II	Cambyses_II
े ट	े_ट
decorations are	decorations_are
Zhenguo Circuit 鎮國	Zhenguo_Circuit_鎮國
MidAmerican Energy	MidAmerican_Energy
smart TVs	smart_TVs
the pitch	the_pitch
Middleweight Champion	Middleweight_Champion
Ap Lei Chau	Ap_Lei_Chau
joint statement	joint_statement
20th Street	20th_Street
Attitude Era	Attitude_Era
civil liberties	civil_liberties
National Enquirer	National_Enquirer
finish as runners-up	finish_as_runners-up
any specific	any_specific
coordination complexes	coordination_complexes
the election with	the_election_with
Satpura Range	Satpura_Range
Bart and Lisa	Bart_and_Lisa
Pompano Beach	Pompano_Beach
the actual	the_actual
Hittite Empire	Hittite_Empire
Free Gaza Movement	Free_Gaza_Movement
Fritz Kreisler	Fritz_Kreisler
Great Heathen Army	Great_Heathen_Army
Endre Ady	Endre_Ady
Justyna Steczkowska	Justyna_Steczkowska
keeping track	keeping_track
a murderer	a_murderer
is a Somali	is_a_Somali
Atlantic Avenue	Atlantic_Avenue
mortal world	mortal_world
an industrial	an_industrial
the Heritage Foundation	the_Heritage_Foundation
Apopka Florida	Apopka_Florida
would soon be	would_soon_be
the murder scene	the_murder_scene
Heltah Skeltah	Heltah_Skeltah
wild mushrooms	wild_mushrooms
du Pré	du_Pré
Keke Palmer	Keke_Palmer
broken nose	broken_nose
Gianfranco Fini	Gianfranco_Fini
Jim Keltner	Jim_Keltner
Davey Richards	Davey_Richards
mathematical equations	mathematical_equations
Commonwealth Foundation	Commonwealth_Foundation
family Scissurellidae	family_Scissurellidae
lowland areas	lowland_areas
Inducted into	Inducted_into
administrative personnel	administrative_personnel
would generally be	would_generally_be
Borough Alaska	Borough_Alaska
brine shrimp	brine_shrimp
heated arguments	heated_arguments
agricultural labourers	agricultural_labourers
a vast	a_vast
in the 1976	in_the_1976
Flemington Racecourse	Flemington_Racecourse
Baronetcy of	Baronetcy_of
Lord Louis Mountbatten	Lord_Louis_Mountbatten
distorted guitar	distorted_guitar
Bricklayers Arms	Bricklayers_Arms
Birkenfeld district	Birkenfeld_district
grow vegetables	grow_vegetables
Slate Magazine	Slate_Magazine
trimethoprim sulfamethoxazole	trimethoprim_sulfamethoxazole
a waiver	a_waiver
Novi Beograd	Novi_Beograd
reflecting on	reflecting_on
Between 1968	Between_1968
Hamilton Spectator	Hamilton_Spectator
prepares to	prepares_to
collections including	collections_including
laid out for	laid_out_for
moist forest	moist_forest
fabulously wealthy	fabulously_wealthy
Fourteen teams	Fourteen_teams
was destroyed on	was_destroyed_on
Hải Phòng	Hải_Phòng
her right leg	her_right_leg
a family of	a_family_of
Countess Palatine	Countess_Palatine
Ynys Môn	Ynys_Môn
Westminster Choir	Westminster_Choir
the Pleiades	the_Pleiades
charging station	charging_station
Attorneys General	Attorneys_General
Saint James	Saint_James
general anesthesia	general_anesthesia
cold-blooded murder	cold-blooded_murder
Adam Clayton	Adam_Clayton
mentally impaired	mentally_impaired
Research Lab	Research_Lab
Mazhabi Sikhs	Mazhabi_Sikhs
the reaction mixture	the_reaction_mixture
the church	the_church
Curb Your Enthusiasm	Curb_Your_Enthusiasm
Dallas Mavericks	Dallas_Mavericks
Heyting algebra	Heyting_algebra
before later joining	before_later_joining
acts on	acts_on
CFDA Vogue	CFDA_Vogue
polygamous marriages	polygamous_marriages
Cindy Crawford	Cindy_Crawford
འ ི་	འ_ི་
report card	report_card
Le roi	Le_roi
599 GTB	599_GTB
and research activities	and_research_activities
Edna Krabappel	Edna_Krabappel
biological weapon	biological_weapon
Edith Sitwell	Edith_Sitwell
Skinny Puppy	Skinny_Puppy
leads into	leads_into
Lindsey district	Lindsey_district
we suppose	we_suppose
60 minutes	60_minutes
orders her to	orders_her_to
comes into	comes_into
the Colombo Plan	the_Colombo_Plan
20H 20Lienhard	20H_20Lienhard
In 1613	In_1613
Ernst Lubitsch	Ernst_Lubitsch
its tributary	its_tributary
clips from	clips_from
Seattle Mariners	Seattle_Mariners
charitable causes	charitable_causes
Confucianism Taoism	Confucianism_Taoism
brought prosperity	brought_prosperity
Air Express	Air_Express
closeness to	closeness_to
greater honeyguide	greater_honeyguide
survived by	survived_by
natural satellites	natural_satellites
at Burnley	at_Burnley
Del Mastro	Del_Mastro
400 feet	400_feet
Guest Conductor	Guest_Conductor
The vehicle	The_vehicle
Fazlul Haque	Fazlul_Haque
Perfection of Wisdom	Perfection_of_Wisdom
a platoon	a_platoon
three gradings given	three_gradings_given
Marawi City	Marawi_City
Scott Pilgrim	Scott_Pilgrim
scoring 13	scoring_13
Adrian Willaert	Adrian_Willaert
recruitment of	recruitment_of
Dejan Lovren	Dejan_Lovren
Walled Lake	Walled_Lake
AAMI Park	AAMI_Park
Mountstuart Elphinstone	Mountstuart_Elphinstone
holding that	holding_that
raising awareness	raising_awareness
less skilled	less_skilled
Charlie Chan	Charlie_Chan
a front for	a_front_for
RNA and DNA	RNA_and_DNA
Stonewall Riots	Stonewall_Riots
Bob Gainey	Bob_Gainey
Mystic Seaport	Mystic_Seaport
West Was	West_Was
Earth s	Earth_s
Ski jumping	Ski_jumping
My Voice	My_Voice
Helmut Zemo	Helmut_Zemo
Strategic Missile	Strategic_Missile
prepare him for	prepare_him_for
Broadcast Center	Broadcast_Center
and General Dynamics	and_General_Dynamics
NFL season	NFL_season
longtime collaborators	longtime_collaborators
van Loo	van_Loo
marginalized groups	marginalized_groups
Art Direction	Art_Direction
Most Popular Newcomer	Most_Popular_Newcomer
Population 2013 est	Population_2013_est
an editorial	an_editorial
Philip Seymour Hoffman	Philip_Seymour_Hoffman
Teenage Fanclub	Teenage_Fanclub
Publisher M H	Publisher_M_H
the butt of	the_butt_of
the area that	the_area_that
just aft	just_aft
commercial vehicles	commercial_vehicles
Blondie s	Blondie_s
basketball competitions	basketball_competitions
Parachrostiinae 1867 1-136	Parachrostiinae_1867_1-136
Tonbridge and Malling	Tonbridge_and_Malling
Usha Uthup	Usha_Uthup
Daimler Fleetline	Daimler_Fleetline
Sydney Sixers	Sydney_Sixers
40th minute	40th_minute
done via	done_via
and engineered by	and_engineered_by
thirteenth season	thirteenth_season
Pharmaceutical Sciences	Pharmaceutical_Sciences
contributions towards	contributions_towards
an EF3	an_EF3
hard line	hard_line
Antonov An-24	Antonov_An-24
Ship Island	Ship_Island
trade unions	trade_unions
Eddie Guerrero	Eddie_Guerrero
A penumbral	A_penumbral
a bribe	a_bribe
South Waziristan	South_Waziristan
portrait photography	portrait_photography
Choral Festival	Choral_Festival
Southern California	Southern_California
Hockey East	Hockey_East
No 51	No_51
Sharni Vinson	Sharni_Vinson
trium liberorum	trium_liberorum
will probably	will_probably
prelate who	prelate_who
north London	north_London
The relationship of	The_relationship_of
would write	would_write
Eventually he	Eventually_he
indigenous groups	indigenous_groups
Indian classical	Indian_classical
constitutional amendment	constitutional_amendment
physical abuse	physical_abuse
bombing missions	bombing_missions
In 1776	In_1776
Saturday night	Saturday_night
Vajrayana Buddhism	Vajrayana_Buddhism
Glastonbury Festival	Glastonbury_Festival
Galena Illinois	Galena_Illinois
astroturf pitch	astroturf_pitch
Mount Barker	Mount_Barker
Machine Readable	Machine_Readable
Dąbrowa Biskupia	Dąbrowa_Biskupia
central Poland	central_Poland
Small Craft	Small_Craft
Yoo Jae-suk	Yoo_Jae-suk
Paradise Garage	Paradise_Garage
two towns	two_towns
laser diodes	laser_diodes
The release of	The_release_of
Krisztián Sárneczky	Krisztián_Sárneczky
Hrvatske ceste	Hrvatske_ceste
classify it as	classify_it_as
Ancrene Wisse	Ancrene_Wisse
et de sculpture	et_de_sculpture
is a 1978	is_a_1978
evaluated as	evaluated_as
Pharmaceutical Benefits	Pharmaceutical_Benefits
a massacre of	a_massacre_of
Special Areas	Special_Areas
Gaozong s	Gaozong_s
burden on	burden_on
instructions are	instructions_are
Long Depression	Long_Depression
the Dniester	the_Dniester
highly symbolic	highly_symbolic
Rassemblement Démocratique	Rassemblement_Démocratique
a three-piece	a_three-piece
Unborn Child	Unborn_Child
their ninth	their_ninth
Dash 7	Dash_7
Falaise Gap	Falaise_Gap
local traffic	local_traffic
In 1739	In_1739
an action for	an_action_for
vocal trio	vocal_trio
cult classics	cult_classics
Jolly Boys	Jolly_Boys
Iraqi officials	Iraqi_officials
Navigation Company	Navigation_Company
Les Contes	Les_Contes
an Italian	an_Italian
tetrastyle portico	tetrastyle_portico
Mink Stole	Mink_Stole
Parañaque City	Parañaque_City
neutrophil elastase	neutrophil_elastase
at Bangalore	at_Bangalore
Debby Boone	Debby_Boone
Fra Angelico	Fra_Angelico
Alicante Spain	Alicante_Spain
was opened	was_opened
Mike Holmgren	Mike_Holmgren
Nationalist Movement	Nationalist_Movement
wicker baskets	wicker_baskets
59 88	59_88
Chief Government Whip	Chief_Government_Whip
Vowel Shift	Vowel_Shift
nearly completed	nearly_completed
battles including	battles_including
welded steel	welded_steel
sports society	sports_society
contributed substantially to	contributed_substantially_to
secondary alcohols	secondary_alcohols
Megaptera novaeangliae	Megaptera_novaeangliae
his short life	his_short_life
in the Nord	in_the_Nord
Sufian District Shabestar	Sufian_District_Shabestar
nothing new	nothing_new
the banner of	the_banner_of
Red Planet	Red_Planet
Somaly Mam	Somaly_Mam
By 1989	By_1989
Mikhail Saakashvili	Mikhail_Saakashvili
Graduate School	Graduate_School
All-Academic Team	All-Academic_Team
relative importance	relative_importance
She authored	She_authored
an intermediary	an_intermediary
SV Elversberg	SV_Elversberg
imitations of	imitations_of
Stephen Baxter	Stephen_Baxter
peppercorn rent	peppercorn_rent
vertical shaft	vertical_shaft
which dominates	which_dominates
took a turn	took_a_turn
Nuremberg trials	Nuremberg_trials
Amélie Mauresmo	Amélie_Mauresmo
G Karachkina	G_Karachkina
the bridge s	the_bridge_s
moved elsewhere	moved_elsewhere
in this war	in_this_war
Francesca Annis	Francesca_Annis
Le Verrier	Le_Verrier
was overhauled	was_overhauled
would start	would_start
the Rock Island	the_Rock_Island
an affordable	an_affordable
breakfast and lunch	breakfast_and_lunch
a two hour	a_two_hour
Gröbner bases	Gröbner_bases
Dave Simpson	Dave_Simpson
Thutmose IV	Thutmose_IV
Democratic parties	Democratic_parties
Burning Pestle	Burning_Pestle
black tie	black_tie
Miss Texas	Miss_Texas
Landscape Architecture	Landscape_Architecture
Tennis Club	Tennis_Club
Quintin Hogg	Quintin_Hogg
Northern Bullants	Northern_Bullants
leading run-scorer	leading_run-scorer
politicization of	politicization_of
Valmiki Ramayana	Valmiki_Ramayana
Frederick Law Olmsted	Frederick_Law_Olmsted
David M	David_M
million facility	million_facility
Dungeons and Dragons	Dungeons_and_Dragons
professional careers	professional_careers
ভল ি উম	ভল_ি_উম
Rafik Hariri	Rafik_Hariri
geographic location	geographic_location
Jan Hus	Jan_Hus
From 1909	From_1909
Dick Vermeil	Dick_Vermeil
Howard Beach	Howard_Beach
invaded Egypt	invaded_Egypt
Captain EO	Captain_EO
the young artist	the_young_artist
Your Daddy	Your_Daddy
attract females	attract_females
3600 m	3600_m
and hand grenades	and_hand_grenades
Koo Wee Rup	Koo_Wee_Rup
Moringa oleifera	Moringa_oleifera
written and storyboarded	written_and_storyboarded
Carbon nanotubes	Carbon_nanotubes
represented Italy	represented_Italy
methods are	methods_are
Richard Dreyfuss	Richard_Dreyfuss
Sterling Cooper	Sterling_Cooper
colors are	colors_are
Township is one	Township_is_one
the Kansas River	the_Kansas_River
described to be	described_to_be
chooses one	chooses_one
38 sqmi	38_sqmi
a European species	a_European_species
Färjestads BK	Färjestads_BK
adrenaline rush	adrenaline_rush
shed light on	shed_light_on
advertising company	advertising_company
Sweeney s	Sweeney_s
Expeditionary Force	Expeditionary_Force
Chris Willman	Chris_Willman
co-operates with	co-operates_with
a bit	a_bit
has been repeatedly	has_been_repeatedly
Wrestle Kingdom	Wrestle_Kingdom
Megan Mullally	Megan_Mullally
Eddie Redmayne	Eddie_Redmayne
designed by	designed_by
beta decay	beta_decay
Michelle Visage	Michelle_Visage
Anoop Menon	Anoop_Menon
Henry A Wise	Henry_A_Wise
responding to	responding_to
suffices to	suffices_to
malignant melanoma	malignant_melanoma
chancel with	chancel_with
Leinster Senior	Leinster_Senior
Asbury Jukes	Asbury_Jukes
Artemis Entreri	Artemis_Entreri
In 1898	In_1898
orbitofrontal cortex	orbitofrontal_cortex
square root	square_root
Kennet and Avon	Kennet_and_Avon
Scott s	Scott_s
α helices	α_helices
Gower Champion	Gower_Champion
wary of	wary_of
spokesman for	spokesman_for
ISO 26262	ISO_26262
during peak hours	during_peak_hours
in several fields	in_several_fields
could resume	could_resume
Twin Otters	Twin_Otters
San Justo	San_Justo
poet translator	poet_translator
Salvadore Cammarano	Salvadore_Cammarano
high casualties	high_casualties
Air Assault	Air_Assault
Professor of	Professor_of
Bobby Tench	Bobby_Tench
but never	but_never
at this level	at_this_level
Tamil Nadu	Tamil_Nadu
known to infect	known_to_infect
a mountain of	a_mountain_of
Damien Dempsey	Damien_Dempsey
in Dunedin	in_Dunedin
Ancient Greek	Ancient_Greek
Professor John	Professor_John
kabuki actors	kabuki_actors
Hürrem Sultan	Hürrem_Sultan
in the category	in_the_category
The first election	The_first_election
Tu Bishvat	Tu_Bishvat
de Uruguay	de_Uruguay
Never Knew	Never_Knew
salad bar	salad_bar
Since May	Since_May
Forbes magazine	Forbes_magazine
a backbencher	a_backbencher
20 mph	20_mph
parallel bars	parallel_bars
would offend	would_offend
fantasizing about	fantasizing_about
harmed by	harmed_by
commensurate with	commensurate_with
Nobel prize-winning	Nobel_prize-winning
Riverside California	Riverside_California
Teófilo Braga	Teófilo_Braga
Dramatists Guild	Dramatists_Guild
advocated that	advocated_that
ி ம	ி_ம
Orontes River	Orontes_River
Sarah Miles	Sarah_Miles
Youngstown Ohio	Youngstown_Ohio
Rowan Williams	Rowan_Williams
representative of	representative_of
Fas Alzamora	Fas_Alzamora
Clwydian Range	Clwydian_Range
Brad Ausmus	Brad_Ausmus
iridescent blue	iridescent_blue
summer school	summer_school
culled from	culled_from
São Toméan	São_Toméan
a twin-engined	a_twin-engined
Henrik Wergeland	Henrik_Wergeland
Ming court	Ming_court
Frederick Gibberd	Frederick_Gibberd
Shortly after	Shortly_after
Worcestershire Canal	Worcestershire_Canal
Soulcalibur IV	Soulcalibur_IV
And you	And_you
By 1850	By_1850
an end-to-end	an_end-to-end
geological strata	geological_strata
is taken	is_taken
purchased a house	purchased_a_house
Dr med	Dr_med
Donald Rumsfeld	Donald_Rumsfeld
Verwaltungsgemeinschaft Administrative	Verwaltungsgemeinschaft_Administrative
Toledo Walleye	Toledo_Walleye
Mel Lastman	Mel_Lastman
but died	but_died
Guitar Slim	Guitar_Slim
Kryvyi Rih	Kryvyi_Rih
Asian records were	Asian_records_were
music duo	music_duo
survey work	survey_work
a death penalty	a_death_penalty
In 1729	In_1729
public – private	public_–_private
Airedale Terrier	Airedale_Terrier
flowing waters	flowing_waters
ethical conduct	ethical_conduct
hot and often	hot_and_often
County East Azerbaijan	County_East_Azerbaijan
Derek Sherinian	Derek_Sherinian
Léon Theremin	Léon_Theremin
plays guitar	plays_guitar
known popularly as	known_popularly_as
Sangam period	Sangam_period
Primary Care	Primary_Care
Martin Rushent	Martin_Rushent
regulatory issues	regulatory_issues
at various	at_various
Operation Barbarossa	Operation_Barbarossa
Bouncing Souls	Bouncing_Souls
a helicopter	a_helicopter
cardiac surgery	cardiac_surgery
greatly simplifies	greatly_simplifies
the Decatur Staleys	the_Decatur_Staleys
pro bono	pro_bono
MITOS Novocherkassk	MITOS_Novocherkassk
Steam Packet	Steam_Packet
Land Grant	Land_Grant
Bhopal Habibganj	Bhopal_Habibganj
attracted over	attracted_over
Single Action	Single_Action
Gifted Talented	Gifted_Talented
Pruszcz Gdański	Pruszcz_Gdański
Capitoline Hill	Capitoline_Hill
Torneo Cibernetico	Torneo_Cibernetico
would ordinarily	would_ordinarily
Koine Greek	Koine_Greek
naval gunfire	naval_gunfire
Arjen Robben	Arjen_Robben
in Katowice	in_Katowice
domestic helpers	domestic_helpers
Ke Phool	Ke_Phool
Ophichthidae worm snake	Ophichthidae_worm_snake
corpore sano	corpore_sano
Jacques Tati	Jacques_Tati
Animal Rescue	Animal_Rescue
distinct entities	distinct_entities
coconut palms	coconut_palms
Mille Lacs	Mille_Lacs
St Moritz	St_Moritz
dorsal fins	dorsal_fins
two villages	two_villages
area code	area_code
tool and die	tool_and_die
Thutmose III	Thutmose_III
2400 m	2400_m
Arcelor Mittal	Arcelor_Mittal
a dead person	a_dead_person
သ ူ	သ_ူ
vanishing point	vanishing_point
László Rajk	László_Rajk
SpVgg Fürth	SpVgg_Fürth
Thousand Faces	Thousand_Faces
ပည ာ	ပည_ာ
Monday morning	Monday_morning
close season	close_season
Caravan Park	Caravan_Park
nursing care	nursing_care
an admixture	an_admixture
brings her to	brings_her_to
In 1932	In_1932
Volume 5	Volume_5
exchanges between	exchanges_between
Phil Collen	Phil_Collen
high ratings	high_ratings
only open to	only_open_to
Red Electoral Alliance	Red_Electoral_Alliance
In 1960	In_1960
Ricky Butcher	Ricky_Butcher
2013-14 season	2013-14_season
Figure 2	Figure_2
annexed to	annexed_to
Imperial Japan	Imperial_Japan
Darley Stud	Darley_Stud
Slavko Kvaternik	Slavko_Kvaternik
coupling rods	coupling_rods
Doug Pinnick	Doug_Pinnick
Steven Klein	Steven_Klein
Binaca Geetmala	Binaca_Geetmala
Wladimir Klitschko	Wladimir_Klitschko
her then-husband	her_then-husband
histone acetyltransferase	histone_acetyltransferase
insertions and deletions	insertions_and_deletions
ศ ู นย	ศ_ู_นย
Len Cariou	Len_Cariou
Recovery Program	Recovery_Program
militant groups	militant_groups
Real Maryland Monarchs	Real_Maryland_Monarchs
Adam Dutkiewicz	Adam_Dutkiewicz
meters long	meters_long
Ken Doherty	Ken_Doherty
Sammi Cheng	Sammi_Cheng
Valentina Matviyenko	Valentina_Matviyenko
Westminster Assembly	Westminster_Assembly
Ficus religiosa	Ficus_religiosa
metallic tints	metallic_tints
high importance	high_importance
Dandie Dinmont	Dandie_Dinmont
mesic forests	mesic_forests
These locomotives	These_locomotives
By studying	By_studying
stay together	stay_together
pornographic content	pornographic_content
happy couple	happy_couple
at about 2	at_about_2
in the Orne	in_the_Orne
practical applications of	practical_applications_of
coordinating committee	coordinating_committee
boxing referee	boxing_referee
freshwater lake	freshwater_lake
Buffy Sainte-Marie	Buffy_Sainte-Marie
Scritti Politti	Scritti_Politti
voice communications	voice_communications
archaeological work	archaeological_work
in Wilmington	in_Wilmington
zinc chloride	zinc_chloride
Sluggy Freelance	Sluggy_Freelance
ֹ ה	ֹ_ה
Hindu deities	Hindu_deities
Mircea Geoană	Mircea_Geoană
Estoril Praia	Estoril_Praia
El Brazo	El_Brazo
Otaqvar District Langarud	Otaqvar_District_Langarud
Annabella Sciorra	Annabella_Sciorra
Tim LaHaye	Tim_LaHaye
Captain James	Captain_James
Daily Inquirer	Daily_Inquirer
pelvic pain	pelvic_pain
≠ 0	≠_0
François Bayrou	François_Bayrou
cabaret artist	cabaret_artist
Konstantin Nikolayevich	Konstantin_Nikolayevich
Funding School	Funding_School
the destiny of	the_destiny_of
silky sifaka	silky_sifaka
memory bandwidth	memory_bandwidth
lower level	lower_level
Pine Brook	Pine_Brook
18th hole	18th_hole
the first pitch	the_first_pitch
preventing her from	preventing_her_from
negative stereotypes	negative_stereotypes
Bif Naked	Bif_Naked
Hold It Against	Hold_It_Against
Business Insider	Business_Insider
has now been	has_now_been
Oak Grove	Oak_Grove
Livery Companies	Livery_Companies
first conceived	first_conceived
financial disaster	financial_disaster
Mira Mesa	Mira_Mesa
metric spaces	metric_spaces
takes up	takes_up
the Medellín Cartel	the_Medellín_Cartel
hexagonal crystal	hexagonal_crystal
straight-line winds	straight-line_winds
negotiation process	negotiation_process
and features programing	and_features_programing
Anwar Maqsood	Anwar_Maqsood
Detroit Michigan	Detroit_Michigan
crushed stone	crushed_stone
backlog of	backlog_of
the Opposition	the_Opposition
cell biology	cell_biology
Lucien Bouchard	Lucien_Bouchard
In 1648	In_1648
bus stop	bus_stop
local councillor	local_councillor
He remained	He_remained
Anton Reicha	Anton_Reicha
electric instruments	electric_instruments
defined to be	defined_to_be
population increase	population_increase
Progressive Architecture	Progressive_Architecture
Northumberland and Durham	Northumberland_and_Durham
Rohit Ramachandran	Rohit_Ramachandran
NSCAA adidas	NSCAA_adidas
Allied war effort	Allied_war_effort
non-profit group	non-profit_group
requested by	requested_by
Māori culture	Māori_culture
the Future	the_Future
in 1694	in_1694
Delmarva Shorebirds	Delmarva_Shorebirds
Tai Tokerau	Tai_Tokerau
satellite technology	satellite_technology
Hod HaSharon	Hod_HaSharon
bridge builder	bridge_builder
Kenneth Slessor	Kenneth_Slessor
tarot card	tarot_card
art and culture	art_and_culture
comply with	comply_with
construction worker	construction_worker
and Police Leader	and_Police_Leader
In 1857	In_1857
Henri Pescarolo	Henri_Pescarolo
mind-altering drugs	mind-altering_drugs
font-size 85	font-size_85
without adequate	without_adequate
contributing author to	contributing_author_to
Air Chief Marshal	Air_Chief_Marshal
Governors Association	Governors_Association
Political Commissar	Political_Commissar
analog channel	analog_channel
Kuk Sool	Kuk_Sool
Master Mason	Master_Mason
Copper Cliff	Copper_Cliff
the Ashanti	the_Ashanti
a kiss	a_kiss
appeals to	appeals_to
Lucchese crime	Lucchese_crime
the assistant manager	the_assistant_manager
N astirh	N_astirh
was sighted	was_sighted
ֵ ל	ֵ_ל
capacity factor	capacity_factor
Military Command	Military_Command
sacrificed to	sacrificed_to
Daniela Hantuchová	Daniela_Hantuchová
sporting career	sporting_career
Recipients AKCR	Recipients_AKCR
Debre Tabor	Debre_Tabor
settle voluntarily	settle_voluntarily
div Scale	div_Scale
antisubmarine exercises	antisubmarine_exercises
Navy Fleet	Navy_Fleet
102 JAMZ	102_JAMZ
Hold on Me	Hold_on_Me
points were scored	points_were_scored
artists and groups	artists_and_groups
has been under	has_been_under
at all costs	at_all_costs
a ship s	a_ship_s
TriStar Pictures	TriStar_Pictures
a clear day	a_clear_day
may appoint	may_appoint
pattern of	pattern_of
her early childhood	her_early_childhood
red and white	red_and_white
· edit	·_edit
her young	her_young
professional debut for	professional_debut_for
Minister-President of	Minister-President_of
Litt D	Litt_D
drained soils	drained_soils
Justin Allgaier	Justin_Allgaier
Lectures on	Lectures_on
tablet PCs	tablet_PCs
Macchi M	Macchi_M
an acceleration	an_acceleration
Himachal Pradesh	Himachal_Pradesh
9 hours	9_hours
saline soils	saline_soils
in orbit around	in_orbit_around
Critically acclaimed	Critically_acclaimed
Erta Ale	Erta_Ale
budget shortfall	budget_shortfall
Carolingian dynasty	Carolingian_dynasty
10th round	10th_round
Queen Regent	Queen_Regent
Tanzania Togo	Tanzania_Togo
playing football with	playing_football_with
revolving around	revolving_around
sedimentary strata	sedimentary_strata
Ramon Fernandez	Ramon_Fernandez
do whatever	do_whatever
75 0	75_0
spherical symmetry	spherical_symmetry
TV roles	TV_roles
Downey Jr	Downey_Jr
extra-marital affairs	extra-marital_affairs
All Day	All_Day
abdominal aorta	abdominal_aorta
is a 1965	is_a_1965
Mount Tamalpais	Mount_Tamalpais
Queensboro Bridge	Queensboro_Bridge
his prison sentence	his_prison_sentence
Magda Olivero	Magda_Olivero
giallo film	giallo_film
many cases	many_cases
recording songs	recording_songs
relief panels	relief_panels
refresher course	refresher_course
All-Star Futures Game	All-Star_Futures_Game
adrenal gland	adrenal_gland
the 107th	the_107th
The tour	The_tour
an 11-point	an_11-point
National Committeewoman	National_Committeewoman
financial distress	financial_distress
ਾ ਲ	ਾ_ਲ
Tokyo Metropolitan Government	Tokyo_Metropolitan_Government
focuses heavily on	focuses_heavily_on
Ba Cụt	Ba_Cụt
more powerful	more_powerful
The Classroom for	The_Classroom_for
Toby Whithouse	Toby_Whithouse
Zürcher Oberland	Zürcher_Oberland
Annual General Meeting	Annual_General_Meeting
Umeå Sweden	Umeå_Sweden
Blue Note label	Blue_Note_label
Comparative Anatomy	Comparative_Anatomy
Korać Cup	Korać_Cup
days until	days_until
hydrogen sulphide	hydrogen_sulphide
Madras India	Madras_India
Error rider	Error_rider
ties to	ties_to
was renumbered	was_renumbered
Tuesdays and Fridays	Tuesdays_and_Fridays
Choctaw Nation	Choctaw_Nation
Société Française	Société_Française
Montgomery Blair	Montgomery_Blair
pale golden	pale_golden
is a Ugandan	is_a_Ugandan
an adept	an_adept
Katholieke Universiteit	Katholieke_Universiteit
British explorer	British_explorer
prehistoric period	prehistoric_period
jazz saxophonist	jazz_saxophonist
twelve feet	twelve_feet
re-branded as	re-branded_as
gender discrimination	gender_discrimination
changed hands	changed_hands
screech owls	screech_owls
Avram Iancu	Avram_Iancu
community-acquired pneumonia	community-acquired_pneumonia
traveled to	traveled_to
County Wisconsin	County_Wisconsin
From that date	From_that_date
Bishop of	Bishop_of
ी ह	ी_ह
a foreigner	a_foreigner
Saif al-Islam	Saif_al-Islam
Late Triassic	Late_Triassic
law and medicine	law_and_medicine
eventual champions	eventual_champions
two bays	two_bays
Kamieniec Ząbkowicki	Kamieniec_Ząbkowicki
$50 billion	$50_billion
175 m	175_m
Empress Theodora	Empress_Theodora
nervous system	nervous_system
van Beuningen	van_Beuningen
